0 0 0 0 0 0 X 0 0 S
0 0 0 0 X X X 0 0 0
0 0 0 0 0 0 0 0 0 X
X 0 X X 0 0 0 0 0 X
X 0 0 X 0 0 0 G X 0
X 0 0 0 0 0 0 0 0 X
0 0 0 0 X X X X 0 0
